11111111111
1P000000001
10011100001
100111E0101
100111001C1
11010001111
11111111111
