11111111111
1P00C000001
10011100001
1001C100101
1001C1001E1
1100C001111
11111111111
